#######################################@@@#################""""""""""""""""""""""
#  #                #          #      #       #           #""""""""""""""""""""""
#  #                           #      ##      @           #""""""""""""""""""""""
#0 #1   3   1   1                     ###     @  4  4   4 #""""""""""""""""""""""
#######################               ####    #############""""""""""""""""""""""
#                           #####    ######   #           #""""""""""""""""""""""
#                          #####    ###       @           #""""""""""""""""""""""
#                         ###  #   ####       @         4 #""""""""""""""""""""""
#                  3     ##  5 #      #       #@@###@@#####""""""""""""""""""""""
#@@###  ###@@###@@###@@###   ###      #      ##    #    ###""""""""""""""""""""""
#    #    #    #    #    #1    ##     #     ###    #    ###""""""""""""""""""""""
#    #    #    #    #    ####  ###    #    ####  4 #  4 ###""""""""""""""""""""""
#    #    #    #    #     @    ####   #___#################""""""""""""""""""""""
# 1  #  3 # 1  # 1  # 3   @  3 #      #                   #""""""""""""""""""""""
################################      #                   @""""""""""""""""""""""
################################     ##        1   3  1   @""""""""""""""""""""""
################################    ###    ################""""""""""""""""""""""
                               #   ####        #############"""""""""""""""""""""
                               #      ##       ##################################
                                      ###    1 #      #         #################
 3   3  1  3   1   1  1  1  3         ####  ####      #         #    #    #    ##
#################################                               #2 5 #9   #5 0 ##
##################################                     0      5 ######    #######
############################################@@@####  #####   ####    #    #    ##
#                          ##############      #      #         #0 2 ######2 5 ##
#                          ##############      #      #         ######    #######
#                 ##       #            #     ##      #         #    #2 2 #    ##
#3   3   3   3    ###      #            #    ###    3 # 1     3 #5 0 ######5 0 ##
################  ####                      #####################################
#                 #####                        #     #          #    ####      ##
#                 #         3  1     1         #877  #          #0 5 ####2 0 5 ##
#3  3  3   3   3  #        ######    #####     #777             #################
###################       #######   #######    #777       1  1  #    #  #      ##
#  ######         #      ########  #########   ########  ########5 2 #5 #5 2 0 ##
#2 #    #         #     ####            #                #      #################
####9   #         #    #####            #                #      #    #  #  #  #
#  #    #         #   ######3    1    3 #                #1 1 1 #2 0 #2 #0 #5 #2
#2 #    #   3  3  _        ####  ##  ####      ##################################
#########  ###### _        #                  ###################    #  #  #  #
#  #              _        #                 #########      #####5 2 #0 #2 #2 #2
#2 #3       3  3  _        # 1   3   1      ##########2 2 2 #####################
########@@@#########       ##############      ##################    #         ##
#      #   #      ###      #            #      #      #    #    #2 0 #         ##
#2 2 2 #   #2 2 2 ####     @            ##     #      #9   #    #################
########   ############    @            ###           _    _    #    #  #  #  ###
#      #   #      ######6  @ 5   1    3 ####      3   _    _ 3  #5 2 #0 #5 #2 ###
#      #   #      ###########################@@##################################
#2 2 2 # 3 #2 2 2 #####################        ##################################
#######################################        ##################################
#                 #####################        ##################################